1111111111111111111111111111111111111111
1000000000000000111111110000000000000001
100000C00000000011111111000000000C000001
1000011111000000111111110000001111100001
1000011111000000111111110000001111100001
1000011111000000111111110000001111100001
1000011111000000111111110000001111100001
1000000000000000000000000000000000000001
1000000000000000000000000000000000000001
1000000000111110000000000111110000000001
1000000000111110000000000111110000000001
10000000000000000000E0000000000000000001
1001111111100000011111100000011111111001
1000111111000000011111100000001111110001
10000C11C0000111111111111110000C11C00001
1000111111000000011111100000001111110001
1001111111100000011111100000011111111001
1000000000000000000000000000000000000001
1000000000111111111001111111110000000001
1000000000000000000000000000000000000001
10000000000000000000P0000000000000000001
1000000000111111111001111111110000000001
1000000000000000000000000000000000000001
1001111111100000011111100000011111111001
1000111111000000011111100000001111110001
10000C11C0000111111111111110000C11C00001
1000111111000000011111100000001111110001
1001111111100000011111100000011111111001
1000000000000000000000000000000000000001
1000000000111110000000000111110000000001
1000000000111110000000000111110000000001
1000000000000000000000000000000000000001
1000000000000000000000000000000000000001
1000011111000000111111110000001111100001
1000011111000000111111110000001111100001
1000011111000000111111110000001111100001
1000011111000000111111110000001111100001
100000C00000000011111111000000000C000001
1000000000000000111111110000000000000001
1111111111111111111111111111111111111111