111111111111111111
110111110000111111
110000000000001111
100100011100000001
1001111111100111P1
100011E11111001111
100000011111000111
11001111111C000101
100011111111000001
111111111111111111
