11111111111111111111111
1C011C011C011C011C01101
11001100110011001100111
11100110011001100110011
11000110000011110000111
11000010010001111100001
10000110001101100001111
10001100001100000001101
11000000011100011001111
11000000111P0000000E111
111C01110001C0000001111
11111111111111111111111