11111
1PE01
11101
1C001
11111
