1111111111
1001100001
1001110001
1100111001
11C0000E01
1100000001
1111110001
1100000011
11101010P1
1111111111